L,L,L,L,L,L,L,L,L,L,L,L,L,L,L,L,L,L,L,L,L,L,L,L,L
L,L,L,L,L,L,L,L,L,L,L,L,L,L,L,L,L,L,L,L,L,L,L,L,L
L,L,L,L,L,L,L,L,L,L,L,L,O,O,O,O,O,L,L,L,L,L,L,L,L
L,L,L,L,L,L,L,L,L,L,L,L,L,L,L,L,O,L,L,L,L,L,L,L,L
L,L,L,L,L,L,L,L,L,L,O,L,L,L,L,L,O,L,L,L,L,L,L,L,L
L,L,L,L,L,L,L,L,L,L,O,L,L,L,L,L,O,L,L,L,L,L,L,L,L
L,L,L,L,L,L,L,L,L,L,L,L,O,O,O,O,O,L,L,L,L,L,L,L,L
L,L,L,L,O,O,L,L,L,L,L,L,L,L,L,L,L,L,L,L,L,L,L,L,L
L,L,L,L,O,O,L,L,L,L,L,L,L,L,L,L,L,L,L,L,L,L,L,L,L
L,L,L,L,L,L,L,L,L,L,L,L,L,L,L,L,L,L,L,L,L,L,L,L,L
L,L,L,L,L,L,L,L,L,L,L,L,L,L,L,L,L,L,L,L,L,L,L,L,L
L,L,L,L,L,L,O,O,O,O,O,O,O,L,L,L,L,L,L,L,L,L,L,L,L
L,L,L,L,L,L,L,L,L,L,L,L,L,L,L,L,L,L,L,L,L,L,L,L,L
L,L,L,L,O,O,O,O,O,L,L,L,L,L,L,L,L,L,L,L,L,L,L,L,L
L,L,L,L,L,L,L,L,O,L,L,L,L,L,L,L,L,L,L,L,L,L,L,L,L
L,L,L,L,L,L,L,L,O,L,L,L,L,L,L,L,L,L,L,L,L,L,L,L,L
L,L,L,L,L,L,L,L,O,L,L,L,L,L,L,L,L,L,L,L,L,L,L,L,L
L,L,L,L,L,L,L,L,O,O,L,L,L,L,L,L,L,L,L,L,L,L,L,L,L
L,L,L,L,L,L,L,L,O,L,L,L,L,L,L,L,L,L,L,L,L,L,L,L,L
L,L,L,L,L,L,L,L,O,L,L,L,L,L,L,L,L,L,L,L,L,L,L,L,L
L,L,L,L,L,L,L,L,O,L,L,L,L,O,O,O,O,O,L,L,L,L,L,L,L
L,L,L,L,L,L,L,L,O,L,L,O,L,L,L,S,L,O,L,L,L,L,L,L,L